##########
#P.#...X,#
#.###.####
#..##.. .#
#.###..#.#
#..####..#
#........#
#........#
##########
