##########
#P#....E.#
#.#.##.#.#
#........#
#.#.##.#.#
#..####..#
#........#
#........#
##########
